,월,화,수,목,금
9:00-10:00,,,,,
10:00-11:00,,,,,
12:00-13:00,,,,,
13:00-14:00,,,,,
14:00-15:00,,,,,
15:00-17:00,,,,,
17:00:18:00,,,,,
